Jose Antonio Olvera	male
Blue Room Innovation	male
Scott Ainsworth	male
candi cadiz munoz	female
Shawn M. Jones	male
Yasmina Anwar	female
Kings web it	male
Carles Serradell	male
Madalina - Carla	female
Ciro Llueca	male
Daniel Ruiz Mestre	male
Rosmery	female
Mohamed Aturban	male
Centre Easy	male
Gina Xifra	female
Mat Kelly	male
Enric Galceran	male
Gerard Pons	male
Michael A. Herzog	male
Justin F Brunelle	male
Paulo Carrillo	male
Albert Trias	male
Ernest Bofill Ylla	male
Albert Saavedra	male
ANTONIO OLVERA GAGA	male
Elisabet Blanch	female
La Liga de Futbol	female
It is forever	male
David Plaza	male
